NO ./textures/north_wall.png
SO ./textures/south_wall.png
WE ./textures/west_wall.png
EA ./textures/east_wall.png

F 255, 0, 0
C 0, 255, 0

11111
10001
10N01
10001
11111